37 0 0 0 35 0 0 0 0 0 0 0 0 0 0 3 
37 0 0 0 35 0 0 0 0 0 0 0 0 0 0 3
37 0 0 0 35 0 0 0 0 0 0 0 0 0 0 0
23 14 15 16 25 0 0 0 0 0 0 0 0 0 0 0
26 29 17 29 32 0 0 0 0 0 0 0 0 0 0 3
2 21 17 22 2 0 0 0 0 0 0 0 0 0 0 3
2 21 17 22 2 11 12 13 0 0 0 0 0 0 0 3 
0 18 19 20 0 0 0 0 0 0 0 0 0 0 0 3
0 0 0 0 0 0 0 0 0 0 0 0 0 0 0 3
0 0 0 0 0 0 0 0 0 0 0 0 0 0 0 3
0 0 0 0 0 0 0 0 0 0 0 0 0 0 0 3
4 4 4 4 4 4 4 4 4 4 4 4 4 4 4 5